+-+-+-+-+-+-+-+-+-+-+
| |  E| | |  E      |
+ + +-+ + + +-+-+ + +
|   |   | | | |E| | |
+-+ + + + +-+ + +-+ +
|   |E|           |E|
+-+ + + +-+ +-+ +-+ +
|   | |  E| | |     |
+ +-+-+ +-+ + +-+-+-+
|E| | |   |   |  E  |
+ + + + + + +-+-+ +-+
|     | | |  E| |   |
+ +-+ +-+ +-+-+ + + +
|  E|       |     | |
+ +-+-+ +-+-+ +-+-+-+
|   |E      | |  E| |
+-+-+-+-+-+ + + +-+ +
|F| |   | | | |E  | |
+ + + +-+ + + +-+ + +
|      E            |
+-+-+-+-+-+-+-+-+-+-+
0