+-+-+-+-+-+-+-+-+-+-+
| | |E|   |E    |E  |
+ + + + +-+-+ +-+-+ +
|   | | |          E|
+ +-+ + +-+ + +-+-+ +
|E    | | | | | |  E|
+-+-+ + + + + + + + +
|E|   | |  E|   | |E|
+ +-+ + +-+-+ +-+-+ +
| | |E  |       |F E|
+ + +-+ + + +-+ +-+ +
|   |  E  | | | |E E|
+-+ + + + +-+ + +-+ +
|   | | |E  |E    |E|
+-+ +-+ + + +-+-+-+ +
| |     | |   |    E|
+ +-+-+-+ + + +-+ + +
|         | |E  |E|E|
+-+-+ + + +-+ + +-+ +
|    E| |  E| |     |
+-+-+-+-+-+-+-+-+-+-+
90