+-+-+-+-+-+-+-+-+-+-+
|     |E  | |      F|
+-+-+ + +-+ +-+-+ +-+
|        E| |   |   |
+ + +-+ +-+ + +-+-+ +
|E| | |       |   |E|
+-+ + + +-+-+ +-+ + +
| |  E|   |E| | | | |
+ + +-+ + + +-+ + + +
|E|   | | | | |    E|
+ + + + + + + +-+ +-+
| | | | | |         |
+ + + + +-+ +-+-+ +-+
| | |E| | | |E|   |E|
+ +-+ +-+ + + + +-+ +
|     |   |   | |   |
+ + +-+-+ +-+-+ +-+ +
| |  E| |    E    | |
+ + + + +-+-+ +-+-+ +
| | |            E  |
+-+-+-+-+-+-+-+-+-+-+
270