+-+-+-+-+-+-+-+-+-+-+
| | |   | |E  |   |E|
+ + + +-+ +-+ +-+ + +
|  E      |   |E  | |
+-+ +-+ +-+ + + + + +
|     | | | |   |   |
+ + + +-+ +-+ + +-+-+
| | | |E  |   |    E|
+-+ +-+-+ + + + +-+-+
| |E|       |E|     |
+ + + +-+ +-+-+ + + +
| | | |   | | | |E| |
+ + + + + + + + +-+ +
| |E| | | | | | |  E|
+ + +-+-+-+ + + + +-+
|E|   |      E| |   |
+ + +-+-+ + + + + +-+
| |E|     | | | |   |
+ + +-+ +-+ +-+ +-+-+
|        E|  E     F|
+-+-+-+-+-+-+-+-+-+-+
270